Sirapat Chiewchanwattana : TkbVWiMAAAAJ // ใช้แล้ว
Sarun Apichontrakul : yqNNqdAAAAAJ // ใช้แล้ว
Pusadee Seresangtakul : E01V5gUAAAAJ // ใช้แล้ว
Chanon Dechsupa : -ZwgaUsAAAAJ // ใช้แล้ว
Sumonta Kasemvilas : jchtQ6gAAAAJ // ใช้แล้ว
Nagon Watanakij :
Sartra Wongthanavasu : brgiVtgAAAAJ // ใช้แล้ว
Chakchai So-In : X0qzPOIAAAAJ // ใช้แล้ว
Punyaphol Horata : 00JXDiUAAAAJ // ใช้แล้ว
Ngamnij Arch-int :
Urachart Kokaew : eZGNz8cAAAAJ
Chaiyapon Keeratikasikorn :
Wararat Songpa : VfmVWLIAAAAJ
Khamron Sunat : eMdpRLEAAAAJ
Pipat Reungsang : E1k8_KEAAAAJ
Boonsup Waikham : sAp1BWsAAAAJ // ใช้แล้ว
Wachirawut Tamviset : zmQuQoIAAAAJ
Urawan Chanket :
Saiyan Saiyod : ksJyxM4AAAAJ
Paweena Wanchai : FXajoHAAAAAJ
Satit Kravenkit : wBQeptEAAAAJ
Silada Intarasothonchun :
Chitsutha Soomlek : ghQ1lTAAAAAJ
Monlica Wattana : 6aUFvc8AAAAJ
Isoon Kanjanasurat : Vos5zq4AAAAJ
Praisan Padungweang : bzF_BIkAAAAJ
Sakpod Tongleamnak :
Pongsathon Janyoi : fn94QPIAAAAJ
Warunya Wunnasri : YT1Se0AAAAJ
Jakkrit Kaewyotha : hk7hj_gAAAAJ
Phet Aimtongkham : HZNNCj4AAAAJ
Arfat Ahmad Khan :
Wanchaloem Nadda : ZmxX5qoAAAAJ
Wasana Putklang : vnTKGAcAAAAJ
Pakarat Musikawan : dxQuB2QAAAAJ
Yanika Kongsorot : zdBo3cwAAAAJ 
Thanaphon Tangchoopong : xF4E8-gAAAAJ
Pobporn Danvirutai : EdGy9eEAAAAJ